#####################
# #############  ####
##  #######       ###
#### ###          ###
##        EFGH!    ##
#   !     IABR     ##
#####       ###  ####
#########       #####
#####       ###  ####
#####################
